点击=id或xpath||控件名称
点击(硬)=id或xpath||控件名称
点击windows控件=窗口文本||控件系统名称||控件名称
输入=id或xpath||控件名称||输入的值
选择单选按钮或复选框=id或xpath||控件名称||是或否
滚动到控件=id或xpath||控件名称
悬停=id或xpath||控件名称
双击=id或xpath||控件名称
右键=id或xpath||控件名称
拖拽=拖拽开始的id或xpath||拖拽开始的控件名称||拖拽结束的id或xpath||拖拽结束的控件名称
选择by文本=id或xpath||控件名称||选择的文本
选择by值=id或xpath||控件名称||选择的值
选择by序号=id或xpath||控件名称||选择的序号
验证是否存在=id或xpath||控件名称||是或否||等待秒数
得到是否存在=id或xpath||控件名称||存放的变量
得到文本=id或xpath||控件名称||存放的变量
验证文本=id或xpath||控件名称||期望的文本
得到值=id或xpath||控件名称||存放的变量
验证值=id或xpath||控件名称||期望的值
验证是否选中=id或xpath||控件名称||是或否
得到选中状态=id或xpath||控件名称||存放的变量
得到属性=id或xpath||控件名称||属性名||存放的变量
验证属性=id或xpath||控件名称||属性名||期望的属性值
移除属性=id或xpath||控件名称||属性名
修改属性=id或xpath||控件名称||属性名||新的属性值
强制可输入=id或xpath||控件名称
chrome上传单个文件=文件的路径（使用正斜杠或双反斜杠）
点击js弹出框的确定
点击js弹出框的取消
进入iframe=iframe的id或xpath||iframe名称
退出iframe
切换窗口=窗口的序号(从0开始)
只保留第一窗口
回退窗口
前进窗口
刷新窗口
执行js=js语句||id或xpath||控件名称
发送钉钉消息=钉钉登录账号||钉钉登录密码||接收人1,接收人2||发送内容
得到相对日期=相对于今天的天数(负数表示前，正数表示后，0表示当天)||存放的变量
得到相对时间=单位(\"秒\"或\"分\"或\"小时\"或\"天\"或\"周\")||相对于当前的值(负数表示前，正数表示后，0表示现在)||存放的变量
得到随机数=位数||存放的变量
调试输出=输出的字符串
得到子字符串=来源字符串||开始||结束(不写表示到末尾)||存放的变量
替换字符串=来源字符串||旧的||新的||存放的变量
去除字符串=来源字符串||要去除的字符串||存放的变量
分割后取第几个=来源字符串||分隔符||第几个(从0开始)||存放的变量
mysql查询=mysqlIP||mysql端口||数据库名||用户名||密码||sql语句||存放的变量
mysql执行=mysqlIP||mysql端口||数据库名||用户名||密码||sql语句
键盘单键输入=键
鼠标点击坐标=x||y
鼠标滚轮=滚动值(正数为向下滚动，负数为向上滚动)
鼠标拖拽=x1,y1,y2,y2,x3,y3,xn,yn
屏幕找图并点击=图片的路径（使用正斜杠或双反斜杠）
屏幕找图得到坐标=图片的路径（使用正斜杠或双反斜杠）||左上角x||左上角y||右下角x||右下角y
屏幕区域截图并保存=左上角x||左上角y||右下角x||右下角y||保存图片的路径（使用正斜杠或双反斜杠）
识别图片中的字母和数字=图片的路径（使用正斜杠或双反斜杠）||识别出的文本存放的变量
存储控件的图像=id或xpath||控件名称||图片的路径（使用正斜杠或双反斜杠）
最小化浏览器
最大化浏览器
设置浏览器位置和大小=左||顶||宽度||高度
执行命令=命令||命令输出文本存放的变量
读取多行数据到序列=电子表格路径||序列存放的变量
读取电子表格某单元格文本=电子表格路径||sheet名||行数||列数||存放的变量